11111111121111111113311111111111
11111111111111111333331111112111
12111111111111111113333111211111
11111111111111112111333111111121
11111111111111111111113311111111
11111110000000111111111311111111
11111100000000001111111131111111
11111000333000001111112111111311
11120003333200000111111111111311
11120000333220000111111111111311
11220000011220000111111111113111
11220000001220000111111311113111
11222000000000001111111331133111
11112220000000000111111133331111
11111222100000000011111133331111
11211112211000111001111133331111
11111111221111111100111333331111
11111111111111111110111333311111
11111111111222111111013333311111
11111111111112221111303333111111
11111111111111111111303331111111
11121111111111111113303331111111
11111111333331111333033331111121
11111111113333333331233311111222
11111111111113333333331111122222
11111111211111133333311111222222
11111111111111111333111111222221
11111211111111111111111111122211
11111111111111111111112111111111
11111111111121111111111111111111
11111111111111111111111111111111
11111111111111111111111111111111
